#####F#####
#####.#####
###.....###
###.###.###
###.....###
####.#.####
##...#...##
##..###..##
##.......##
#####.#####
#####S#####
