#####F#####
#####.#####
####...####
####.#.####
####.#.####
####.#.####
####.#.####
####...####
####...####
#####.#####
#####S#####
