#####F#####
#.#.#.#.#.#
#.#.#.#.#.#
#...#.#...#
#.#.#.#.#.#
#.#.....#.#
#.#######.#
#.........#
#.#.#.#.#.#
#...#.#...#
#####S#####
