#####F#####
##....#...#
#..#.##.#.#
##.###..#.#
#..#...##.#
#.##.####.#
#....#..#.#
###.##.##.#
#.###...#.#
#.....#...#
#####S#####
